#########    #
 #          ##
######     ###
####     #   #
###    ####  #
#         #  #
######    #   
#          W #
##############